*********************************************************************************************************************************************
S *     *   *     *     *   *   *   *           *     *   *           *       * *     *       *   *     *   *     *             *   *   *   *
* * *** * * ***** * *** * *** * *** * ********* * *** * * * ********* * ***** * * *** * ***** * * * *** * * * *** * *********** * * * * * * *
*   *     * *   *   *   *     *     *     *   * *   * * *       *     * *     *     * *     * * *   *   * *   *   *   *         * *   *   * *
***** ******* * * ***** * *************** * * *** *** * *** *** * ******* ******* * ********* * ***** *** ***** ***** * ********* ********* *
*     *   *   * * * *   *   *     *   * *   *     *   * *   *   * *       *   *   *       *   *     *   * *   * *   * *     *   * * *       *
* * * *** * *** * * * ***** * *** *** * *********** ***** ******* * ********* * * ******* * ******* *** * * * * *** * ***** * * * * * *******
* * *   * * *   * * *   * * * *   *   *           *           *   *   *     *   *       *   *     *   * * * * *     * *   *   * * *   *   * *
* * *** * * * *** * *** * * * * *** * * ********* ******* *** * ***** * *** *** * ***** ***** *** *** *** * ******* * * * ***** * * *** * * *
* *   *   * *     *     *   * * *   * *         *     *   *   *     * *   *     * *   * *   *   * *   *   *     * *   * * *   *   *     *   *
* ********* ********* *** *** * ***** * ********* * *** *********** * * *********** * * * * ***** * *** ******* * ***** *** * ******* ***** *
*           *     *   *     * *       * *       * *     *     *   *   *     *     * * * * * *   * * * *         *           *     *     *   *
************* *** * ***** * * *********** ***** ******* * *** *** ********* * *** *** * * * * * * * * *** *********** *********** ***** * ***
*     *     *   *   *   * *   *         * *   *       * * *       *       * *   *     *   * * *   *   *   *     *   *   *   *   *     * * * *
* *** * ******* ***** * * ***** ******* * * ***** ***** * *** ***** ***** * *** * ********* * ******* * *** * *** * ***** * * ******* *** * *
*   * *   *     *     * * *     *     * * *         *   *   *       *   *   *   * *       * * *     *       * *   *   *   * * *     *   *   *
*** * * * * ***** ***** * * ***** * *** * ******* * * *** * ********* ******* ***** ***** * * * *** *** ***** * * * *** *** * * * ***** * ***
*   *   *   *     *   * * *       * *   * * *   * *       * *   *   * *       *         *   * *   * *       *   * * *     * * * *   * * * * *
* ***** ***** ******* * * ********* * * * * * * * *** ***** * * *** * * * ********* *** ***** * *** *** *********** * ***** * * *** * * * * *
*   *   *   * *   *   * *         * * *   * * *   *     * * * * *     * * *   *   * *   *   *   *       *   *     *       *   *   *   * * * *
*** * ***** * * *** *** ******* * *** ***** * ********* * * * *** * *** * *** * * *** ***** *** * * ***** * ***** *** *** *** *** *** * * * *
*   * *     *       *   *       * *   *   *   * *       *   *     * *   *   *   * *   *       * * *       *   * * *   *   *   *     *   *   *
*** * * ************* ***** ***** * *** * ***** * ***************** * ***** ***** * *** ******* * *********** * * * *** *** *** *************
*   *   * *     *   *     *     * * * * * *   * *     *   *   *     * *   *     * *     *     * * *           * * * *   * *         *     * *
* ******* * *** * * ***** ***** * * * * * * * * *** * *** * * * ***** * * ***** * *** *** * * *** ******* ***** * * * *** ***** *** * *** * *
* *   *     *   * * *   *   *   * * *   *   *       * *   * * *   *   * *   * * * *   *   * *   *       *   *   *   * *     *   *   * *   * *
* * * * ***** *** *** * *** ***** * ***************** * *** ***** * ******* * * * ***** ******* ***** * *** * ******* ***** * *** *** * *** *
*   *   * *   *     * * *   *     * *         *   * *   *         * * *   * *   * *   *     *   * *   *   * * *         *   *   *   * * *   *
********* * *** *** *** * *** ***** ***** * * * * * ***** ********* * * * * *** * * * ***** * *** * ***** * * * ***** * * ***** *** * * * ***
*     *   * *   *   *   *   * *   * *   * * * * * *     * *   *   * *   * * *   * * * *     * *   * *     *   * *   * *       *   *   *     *
* * *** *** * *** *** ***** * *** * * * *** * * * ***** * * * * *** ***** * * *** * * ******* * * * *********** * * * *** *** *** ******* * *
* *   *     * * * * *     * * *   *   *     *   *         * *       *     * *     * *   *       *   *           * * *   * *   * * *       * *
* *** * ***** * * * ***** * * * *** ************* * *** *** ************* * ***** * * * * *** ******* ***** ***** ***** * ***** * * *********
*   * * *     * *     *     *           *   *     *   *     *   *       * *   *     * * * * *   * *   *         *       *   *     * *       *
*** * * * ***** ***** * * ***** * ***** *** ************* ***** * ***** * * * ******* * * * * * * * ******* *************** ******* * ***** *
* * * * * *           * * *     * *   *   *         *   * *   * * *   *   * *         *   *   * *   *       *       *     *   *   * * *     *
* * *** * * *********** * * ***** * * *** ********* * * * *** * * *** ***** ******************* ***** ******* ***** * *** *** *** * * ***** *
* *     * *   *     *   * *   *   * * *     *       * * *   *   *   *     *     * *   *         *   *   *     *   *   *       *   * *   *   *
* ***** * *** * *** * * * *** * ***** *** * * ******* * *** * ***** * ********* * * * * ***** ***** *** * ***** ***** ********* *** *** * ***
*   *   * *   *   * * * *     *     *     *     *     *     *     * *           *   * * *     *   *     * *   *     * *   *       *   * * * *
* * * *** * ***** * * * *********** *********** * *** *********** * ********* ******* * * ***** * ******* * * ***** *** * ***** * *** * * * *
* * *     *     * *   * *           *     *     *   *       *           *   * *     *   * *   * *       * * *           *     * * *   * *   *
* * ***** * *** * ***** * *********** ***** ******* ******* * ***** * * *** * *** ******* *** * ******* * * ************* * *** * * *** *****
* *       *   *   * *   *       *   *     *   *   *   *   * * *     * *   * *   * *       *   *       *   *         *   * *   * * * *   *   *
************* ***** * ******* * *** *** * *** *** *** * * * * * ********* * *** * * ******* ********* ************* * * ***** * *** * *** * *
*       *   * *       *   *   *     *   *     *   * * * * * * * *   *     * * *   *     *   *   *     *   *   *   *   * *     *     *   * * *
* ***** * * * * ******* *** *** ******* ******* *** * * * * *** * *** ***** * *** ***** *** * * ******* * * * *** ***** * ***** ******* *** *
* * *   * *   *   *   *     * * *       *         *   * * * *   *           *   *   *   *   * *   * *   * * *       *   *       *     *   * *
* * * *********** * * ******* * *************** * ***** *** * *** *** * ******* ***** * * ******* * * *** * ******* * *********** * * *** * *
*   *             * * *   *   *     *     *   * *     *   *   *   *   * *       *     *   *       *   * * * *   * *   *       *   * *   * * *
*********** ********* * * * * *** *** *** * * * *** * *** ***** *** *** * * ***** ******* * ******* *** * * * * * ***** ***** ***** *** * * *
*   *     *     *     * * * * * *     *   * *   *   * *   * *   *   *   * *       *     * * *         *   *   * *   *   *     *     *   *   *
*** * *** ***** * *** * *** * * ******* *** ******* * * *** * * * *************** * * * * * ********* * ******* *** * *** ***** ***** ***** *
*   * * *       *   * *     * *         * *       * * * * * * * *           *   *   * * *   *     *   * *     *     * *     *   *   *   * * *
* *** * ***** * *** ********* *********** ******* * * * * * * ************* * * ***** * ***** *** * *** ***** ***** * * ***** *** * *** * * *
*     * *     *     *     *     *       *     * * * *   * * *     *     *   * * *   * * *   * * * *   *       *     * *     *     * *   *   *
******* *********** * *** * *** * ***** ***** * * * ***** * ***** * *** * ***** * * *** * * * * * *** ********* ***** *** * ******* * *** ***
*       *   * *     *   *   *   * *   *     *     *   *   *       * *   * *     * *     * * *   * * *   * *   * *     *   *         *       *
* ******* * * * ******* ***** *** * * * *** ********* * *** ******* * *** * ***** ********* * *** * *** * * * * * ***** *********** * *******
*   *     *   *       * *   * *   * * *   * *   *     *   *   *   * * *   * *   *   *   *   *   *   *   *   * * * *     *       *   * *     *
*** * ***** ********* * *** *** *** * ***** * * * ******* ***** * * * * *** * * *** * * * ***** *** *** ***** * * ***** ******* * ***** *** *
*       * *           *   * *   * * *   *   * * *       * *   * * * *   *   * *   * * *   *   *   *   * *   * *   *   *     * *   *   * *   *
******* * ***** ********* * * *** * * * * ***** ******* * * * *** * * *** *** *** * * * ***** *** *** * * * * ***** * ***** * *** * * * * ***
*   *   * *     *         * * *     * * * *   * *     * *   *       * *       *   * * *       * * * *   * * *     * *     * * *   * *   *   *
* * * *** * *** * ******* * *** ***** *** * * * * ***** * *********** *** * *** *** * ********* * * ***** ******* * * *** * * * *** ******* *
* *   *   *   *   *     *       *     *   * * * *       *       *   * *   * * * *   *   * *   * * *             *   *   *   * *   *     *   *
* ***** *********** *** ********* ***** ***** * * ************* * * * * *** * * * ***** * * * * * ************* ************* *** ***** * ***
*     * *     * *   *   *           *       *     * *     *   *   * * * *   *   *     * * * *   * *   *     *     *       *   * *   *   *   *
*** * * ***** * * ******* ******* * *** * * *** *** * *** * ******* * * * * ********* * * * *** * * * ***** * * * * ***** * *** *** * ***** *
* * * *     * * * *       *       *     * *     * * * *     *   *   *   * * *     *   *     *   *   *     * * * * * * *   *       * *   *   *
* * * ***** * * * * * ********* ************* *** * * * ***** * ********* * * * * * ********* *** ******* * * *** * * * *** ***** * *** *** *
* * *       * *     *       * * *   *         *   * * * *     *     *     * * * *   *   *     *     *   *   * *   * *   * * *   * * *   *   *
* * *** ***** ************* * * *** * *********** * * * * ***** * *** ******* * ******* * ***** ***** * ******* *** ***** * * * * * * *** ***
*   *     *   *   *         * *     *     *       * * * *     * *     *       *         *   * * *   * * *       *     *     * * * *   *   * *
***** *** * *** * * ********* ******* *** * ******* * ******* * ***************** ******* * * * *** * * * ******* * * * ******* * ***** *** *
*   *   *   *   *   *       *       *   *   *   *             *   *     *         *       *   *   * * * *     *   * * * *   *   *   *   * * *
*** *** ***** * * *** ***** ******* ********* *** *** *** *** *** * *** * ************* ***** *** * * * ***** ******* * * * * ******* *** * *
*   *   *     * *   * *   * *     *               *   *   *   *   * *   *         *     *   * *   *   * *     *   *     * *   * *     *   * *
* * * *** ***** * *** * *** * ********************* * * ******* *** * ************* *** * * * * ***** *** *** * * * ***** ***** * ***** *** *
* * * * *   *   * *   *   * * * *         *         * *   *     *   *       * *   * *   * * *   *   *     * *   * *   * *   * * *       *   *
*** * * *** * * * * *** * * * * * ******* * ************* * ***** * ******* * * * * * *** ******* * * ***** ***** *** * *** * * *** ***** ***
*   * *     * * * *   * * *       *     * * *   * *       * * *   *   *     *   *   *   *       * * *   *   *   * *     *   * *   * *   *   *
* ***** ***** *** *** * * ********* *** * * *** * * ******* * * ******* ***** ***************** * * *** * *** * * * ***** * * *** * * * *** *
*       *   *   *     * * *   *   *   *   * *   * *   *     *   *       *     *       *       *   *   * * *   * * *     * * *   * *   * *   *
********* * *** * ***** * * * * * *** ***** * *** *** * ******* * ******* ***** ***** * ***** ******* * * * ***** ***** *** * * * ***** * ***
*       * *     * *   * *   * * *   *   *   * * *     * *       * * *     *   *   *   *     *         *   * *   * *   * *   * *       *   * *
* ***** * ******* * * * ***** ***** *** * *** * ******* * ******* * * ***** ***** ***** *** *************** * * * *** * * *********** ***** *
*     *   *     *   * *     *     *     * *   * *       *   *     * * *     *   *   *   *     *   *   *     * * * *   * *       *   * * *   *
***** ***** * ******* ***** ***** * ***** * *** * ********* ******* * * *** * * *** ********* * * * * * ***** * * * *** ******* * * * * * ***
*   *     * *   *   * *   *     * * *       * * *   *   * *         * *   * * *   *         * * * * *     * * *       *   *     * * *   * * *
* * ***** * *** *** * * ******* *** * ******* * *** * * * *** ******* *** * * *** ********* * *** * *** * * * ******* *** *** ***** * *** * *
* * *     *   *     * *   *   *     * *   *         * * * * *   *     * * * * * * *       *     *   * * * * * *     * *   *   *     *   * * *
* *** ********* *** * *** * ******* * * * * *********** * * *** * ***** * * * * * * * ********* ***** * * * * * *** * * *** *** ******* * * *
* *         *   *   *     *   *     *   * * *     *     *         *   *   * * *   * *       *   *       *   * *   *   *   *   * *   *     * *
* * * ***** * *** * ********* * ********* *** *** * *********** *** * ***** * ***** ******* * ******* ******* *********** * *** * * * * *** *
*   *   * *   * * * *   *     * *         *   *   *     *     *     * *     * *       *   * *   *     *     * *     *   * *   * * * * *     *
******* * ***** * *** * * * *** ***** ***** * * * ***** * *** ***** * ***** * * *** * * * ***** * ***** *** * * * * * * * *** * * * * * *****
* *     * *   *   *   *   *   *   *   *   * * * *   * * * *     *   *   * * * *   * *   *     *       *   * *   * *   * *   *     * * *     *
* * ***** * * * *** ********* *** * *** * * * * *** * * * * ***** ***** * * * *** *********** *** *** *** * ***** ***** *** * * *** * ***** *
* *     *   * * * * *   *       * *     *   * *   *   * * *       *   *   * *   * *   *   *     * *     * *   *   *   *     * * *   * *   * *
* ***** * *** * * * * * * ***** ********* ******* ***** ***** ***** * * *** *** * * * * * *** * * ***** * *** * *** * ******* *** *** * *** *
*       * * * *   * * * *     *   *       * *   *     *   *   *     * * *   *   *   *   * *   *   *   * * *   * *   *       *   *     *   * *
********* * * ***** * * ***** *** * ******* * * ***** * * ***** ***** * * *** ************* ******* * * * * *** * ********* * * ********* * *
*     *   * *       * * *   *   *   *     *   *     *   * *     *   *         *     * *     *     * * * * *     * * *   * * * * *           *
* *** * *** ******* * * *** * * ********* ********* *** * * *** *** * *** ******* * * * ***** *** *** * * ******* * * * * * *** *** *** * ***
*   *     * *     * * *   * * * *         *       *     *     *   * *   * *     * * *   * *   *     * * *     *   *   * * *     *   *   * * *
*** ******* ***** * * *** * * * * ******* * * *** *************** * *** * * *** * * * *** * *** *** * * *** * * ***** * * ******* ******* * *
*       *         * *   * * * * *       *   *   *   *   *       *   *   * * * * * * *   * * *   *   * * *   *   *     *   *       *     *   *
* * ***** * ******* *** * * * * ******************* * * * ***** ***** ***** * * *** *** * * * *** *** * * ******* ********* ******* * *******
* * *   * * *     *   * * * * *                   * * *   *   * * *   *     *     * *   *   * *       * *       *           *   *   *       *
* *** * *** * *** * *** * * * ******************* * * ***** * * * * ***** ***** * * * *** *** ********* ******* *************** * ********* *
*   * * *   *   * *   * *   * *   *           *   * *       * *   *   *   * *   *   *   * *   *     * * *       *   *           * *       * *
*** * * * ***** * *** * ***** *** * ********* * *** ********* * *** *** *** * ***** *** * * *** *** * * ***** *** * * *********** ***** * * *
*   * *   *     *     *     * *   * *   *       *   *     * * *     *   *   * *       * * *   *   *   *     *   * *     *         *   * *   *
* *** ******* ************* * * * * * * ********* * * *** * * ******* *** *** ********* * ********* ***** ***** * ***** * ********* * * *****
*     *   *   *   *       * * * *   * *   *       * * * *   *   * *       *           *   *         * *     *   * *       * *   *   * * *   *
******* * * *** * * *** * * *** ***** *** * ********* * ******* * * ***************** ***** *** ***** * *** * ***** ******* * * ***** * *** *
*     * * * *   * * *   * *     *     *   *         * * *     * *   *     *     *   *   *   * * *   *   *   * *     *   *     *     * * *   *
* ***** * * * *** * * * ********* * *** ***** ***** * * * *** * * *** *** * *** * * ***** * * * * * * ******* * ***** * *** ******* * * * ***
*       *   * *   * * *       *   *   *     * *   * * *   *     * *   *   *   *   * *   * * *   * * *   *     * *     *     *       *   *   *
***** ********* ***** ********* ********* *** * *** * *** * * *** * *** ***** ***** * * * ******* * *** * ***** * * ********* ************* *
*   *       *   *   * *       *   * *     *   *   *   *   * *       *   *   *   *     *   *   *   *     *     * * * *       *           *   *
* *********** ***** * * ***** *** * * ***** *** * * *** * * ***** ***** * * *** * ********* * * ************* * *** * ***** *********** * ***
*     *       *     * * * *   *     * *   *     * * *   * * *   * *   *   *   * * *         * * *               *   *   * *     *       *   *
***** * ******* ***** * * * *** ***** * * *** *** * ******* * *** * * ******* * * * ********* * * *********** *** ***** * * * * *** ******* *
*     *             * * * *   * *     * * *     * *         *     * *       * * *   *   *   *   *       *       * *     * * * * *   *   * * *
* ************* *** * * * *** * * ***** * * ***** ******* ********* *** ***** * * *** * * * *********** * ******* * ***** *** * * *** * * * *
*   * *           *   * *   *   *       * *   *     *   * *       * * *       * * *   *   *     * *     *         *   *   *   * *   * *   * *
* * * * ********* ***** * * ************* ***** *** * * * * ***** * * ********* * * *********** * * * * * ******* *** * *** *** * * ***** * *
* * *   *   *   * *   * * * * *         *     *   *   * * * *   * *     *   *   * *       *   * *   * * *   *   * * * *     *   * *     *   *
* * * *** *** *** * * * * * * * ******* ***** *** ***** * * * * * ***** * * * *** * *** * * * * * *** ***** *** * * * ******* ********* * ***
* * *   * *   *     *   * * *   *     *     *   *     * * *   * * *     * * *   *   *   * * * * * * * *   * *   *   *       *   *     *   * *
* * *** * * *** * ********* * *** * * ***** *** ***** * ******* * * ***** * *** ********* * *** * * * * *** * *** ********* * *** *** ***** *
* *     *   * * * *   *   * * *   * *     *       *   *         * *       *   *   *       *   *   *   *         *       *   *   *   * *     *
*********** * * *** * * * * * ***** ***** ***** *** ************* *** ******* *** * ********* ********* *********** *** * ***** ***** * * ***
*   *         *   * *   * * *   *   *   *     *     * *         * *   * *     *   *           *       * *   *       *   *     *       * *   *
* * * ***** * *** * ***** * *** ***** ******* *** *** * ******* * ***** * *** * ***************** *** * * * * ************* * ********* *** *
* *   *   * * *   *     *   *   *   *           *     *       * * *   * *   *   *     *         *   *   * *   *   *   *   * *           *   *
* ******* * *** ******* ******* * * ********* * ************* * * * * * *** ********* * ******* *** ***** ***** * * * * * *** ***** ***** ***
*         *           *         * *           *               *     *     *           *       *         *       *   *   *     *         *   E
*********************************************************************************************************************************************