*************************************************************
S *   *   *   * *         *   *       *       *       *     *
* * * * * * * * * ******* * * * ***** * *** * ******* * * * *
*   *   *   * *   *     *   * *     * * *   *   *   *   * * *
************* *** * *** ***** ***** * * ******* *** *** * ***
*       *     * *   * *     *   *   * *   *   *       * *   *
* ***** * ***** ***** ***** *** * *** *** * ********* ***** *
* *   *   *       *       * *   * *   *             *   *   *
* * ******* *** *** * ***** * *** * *********** ******* * * *
* * *         * *   *     * *   * *     *             * * * *
* * * ******* * * *** *** * ***** ***** * ************* * * *
* *   *     * * *   * *   * *     *     *     * *       * * *
* ***** *** *** *** * * *** * ***** ********* * * ***** * * *
*     *   *   *     * *   * * *   *       *   *   *   *   * *
*** ********* * ***** *** * * * * *** *** * ********* ***** *
*       *   *   * *   *   *   * * *   *     * *       *   * *
* ******* * ***** * ***** * *** *** *** * *** * *** *** * ***
* *     * * *   *   *   * *   *     *   *     *   *   * *   *
* * *** *** * * ***** * * *** * ***** ***** ***** * * * *** *
*     *     * *     * * * * * *     *   * * *   * * * * *   *
*** * ******* ***** * * * * * ********* * * *** * * * *** ***
*   *     *   *   *   *   * *       * * * *   * * * *   * * *
* ******* * *** *********** ******* * * * *** * * ***** * * *
* *     * * *         *   * *   *   *   * *     *     *   * *
* * *** * * ******* * * * * * * * ******* * *** ***** * *** *
*   *   *   *     * * * * * * * *   *   *   *   *     * *   *
***** *** *** *** * * *** * *** *** *** *** * *** ***** * * *
*   *   * *   *   * *     *   *       *     *     *   * * * *
* * *** * * *** *** *** *** * *** *** ***** ********* * * * *
* *   * *   *       *     * *   * *       *       *   *   * *
* *** * *********** * *** * *** *** ***** ********* ******* *
*   * * *         * *   * * *   *   *   * *       * *       *
*** *** * ******* ***** *** * *** ***** *** ***** * * *******
*       * *   *       * *   *   * *   *     *   * *     *   *
********* * * * ***** * * ***** * * * ******* *** *** * *** *
*   *   *   * *     *   *     *   * * * *   *   *     *   * *
* *** * ***** ***** ********* ******* * * * *** *** ***** * *
*   * * *   * *   * *   * *   *     * * * *     *       *   *
* * * *** * * * *** * * * * *** *** * * * *********** *******
* *       *   *   *   *   * *   *   *         *         *   *
* *************** *** *** * * *** ******* *** * ******* * * *
* *     *       *   * *     * *   *     *   * * *     *   * *
* * *** * ***** * *** * ***** *** *** * ***** * * *** ***** *
* *   *   * *   * *   * *   * *       * *     * * * * *     *
* *** ***** * *** * * * * * * * ******* * ***** * * * * *****
* *   *   *   *     * * * *   *       *   * *   *   * *     *
* * ***** ************* *** ********* ***** * *** *** ***** *
*     *               * *   *         *   *   *   *   *   * *
* *** * * *********** * * ***** * * *** * ********* * * *** *
*   * * *   *   *     *   *   * * *     * *         * * *   *
*** * * *** * *** ********* * * ********* ***** ******* * * *
* * * *   * *   * *       * * *   *     *       *     *   * *
* * ***** ***** * * * *** * * *** * *** *********** * ***** *
* *   * *       *   * *   * * *   * *   *         * *     * *
* * * * ************* ***** * * *** * *** ******* * ***** * *
* * *   *           *   *   * *     * *     * *   *   * * * *
* * ********* ***** *** * *** ******* *** * * * * *** * * * *
*       *     *           *   *       *   * *   *     * *   *
*** *** * ***** *** ******* ***** ***** *** ***** ***** *** *
*     *   *     *   *       *     *     *       *     *     E
*************************************************************