***************************E*******
*  * *  *******                   *
*  *   ******** * ***** ********* *
S ** ***      * * ***      ****** *
* *  *** **** * * *** **** *****  *
* * **** ****   * *** **** ***** **
*   **** **** * * *** **** ***** **
* * ****      *   ***      ****  **
* ******** **** ******* ******* ***
*                                 *
***********************************