****S**E******
*    *  ***  *
** ***  ***  *
**  ***  **  *
*  **   ***  *
*       ***  *
**************