**************
*            *
S **** ****  *
***  * *******
E *  * ****  *
*       ***  *
**************